111111111111111111111111111
1E01111CC00000CC1CCCCCCCCC1
11000111C00000C111C00CCCCC1
111100011C000000111C0000CC1
1CC0000001000000010000000C1
111C00000000P0000000000CC11
1111001100000011C000000CC11
1100000111C00CC11CC00CC1111
1C00000CC11CC0CC11CCCC11111
1CCC00CC1111CCCCC1111111111
111111111111111111111111111